SO textures/south.xpm
NO textures/north.xpm
EA textures/west.xpm
WE textures/east.xpm


C 150,150,205
F 50,0,150


1111111111111111
1N00000000000001
1001000000000001
1000000000100001
1000100000000001
1000000000000001
1000100000000001
1010000000000001
1000000000000001
1000000000000001
1000000000000001
1000000011000001
1000000000100001
1000100000000001
1000000000000001
1111111111111111
